93D139393B
AC3A86C6AA
AFAAEFFFAA
AFC6957FAA
AFFFAFFFAA
813FAFD542
AAAFAFFF96
EA87C3D3C3
96E93C3A96
C556C56C47

4,3
0,1
SSSSESESWWNWSWWWNENNNWNNNN
